1111111111111111111111111111111
1000000000000000000000000000001
1000000000000000000000000000001
1000000000000000000000000000001
1000000000000000000000000000001
1000000000000000000000000000001
1000000000000000000000000000001
1000000000000000000000000000001
1000000000000000000000000000001
101110000000P000000000000000001
101010000000C000000000000000001
100111000000E000000000000000001
1000000000000000000000000000001
1111111111111111111111111111111