1111111111111
1CC1CCCCCCCC1
1CCCC11111CC1
1P1111E0C0CC1
1111111111111