111111111111111111111
1P00000000001C1000001
111111111100101000001
1C0000000000101000001
111111111100000000001
100000000000000000001
101011111110000000001
101010000000000000001
101010000000000000001
1C1C1000E000000000001
111111111111111111111